11111111111111111111111111111111111
1P000000000000000000000000000000001
10C000C0000C0000C0000C0000C000000C1
10C000C0000C0000C0000C0000C000000C1
10C000C0000C0000C0000C0000C000000C1
10C000C0000C0000C0000C0000C000000C1
10C000C0000C0000C0000C0000C000000C1
10C000C0000C0000C0000C0000C000000C1
111111111101111011110111101111000C1
110011001100011000110001100011000C1
10001000100001000010000100001000EC1
10000000000000000000000000000000001
1C11001100C1100C1100C1100C1100CC0C1
1C0100010000100001000010000100000C1
11111111111111111111111111111111111