1111111111111111111111111111111111
100000000E00000C00000C100000000001
1010010100100000101001000000010101
10100100101010100010010000000C0101
1P0000000C00C000000001000000000001
1111111111111111111111111111111111