1111111
10001
1001111111
11111
11111111